NO /home/ainouni/cub3d/textures/walls/wall_1.xpm   
SO /home/ainouni/cub3d/textures/walls/wall_2.xpm    
WE /home/ainouni/cub3d/textures/walls/wall_3.xpm
EA /home/ainouni/cub3d/textures/walls/wall_4.xpm      

F 255   , 100 ,  0
C 250,  255  ,  255


11111111111111111111
10000000100000011011
10000000000000000001
10000000100N00000011
11110111111111111111
11111111111111111111
1
11111111111111111111
10000000100000011011
10000000000000000001
10000000100000000011
11110111111111111111
11111111111111111111