NO /home/yimizare/Desktop/CUB3D/textures/memes/1.xpm
SO /home/yimizare/Desktop/CUB3D/textures/memes/0.xpm
WE /home/yimizare/Desktop/CUB3D/textures/memes/2.xpm
EA /home/yimizare/Desktop/CUB3D/textures/memes/3.xpm

F 255,0,0
C 255,255,255


11111111111111111111111111111111111
101100000000000001111111111111101
1001000000000000000000011111111111111
111111100100100011111111111111111
100000001000000000000001111111111
10110000011111110000000011111111111
100000000100000000S00001111111111
100000000100000000000000011111111
111111111111111111111111111111111
1111111111111111111111111111111111111