1111111111111111
1000000000000001
1000011111100001
1000000010010101
1000000010110101
1000000010110101
1011000000000001
1111111111111111

NO ./textures/north_texture.xpm
SO ./textures/north_texture.xpm
WE ./textures/east_texture.xpm
EA ./textures/east_texture.xpm

F 255,255,255
C 0, 0, 255
